#####E####
#.....#..#
#.#####.##
#.#...#..#
#.#.#.#.##
#.#.#.#..#
#.#.#.#.##
#...#....#
#.#.#.#.##
#######S##
