######E#
##.....#
##.#####
##.#...#
##.###.#
##.....#
##...#.#
###S####
